111111111111111111111111111
101000000000000000000000001
100100000000000000000100001
100010000000000000000000001
100001000000000000000000001
100000111111110000000000001
100000000000000000000000001
100000000000000000000000001
100000111110000101010000001
100000100010000000000000001
100000100010000100010000001
100000100010000000000000001
100000110110000101010000001
100000000000000000000000001
100000000000000000000000001
100000000000000000000000001
100000000000000000000000001
111111111000000000000000001
110100001000000000000000001
110000101000000000000000001
110100001000000000000000001
110111111000000000000000001
110000000000000000000000001
111111111000000000000000001
110000000000000000000000001
111111111111111111111111111