NO textures/wolfenstein/north.xpm
SO textures/wolfenstein/west.xpm
WE textures/wolfenstein/south.xpm
EA textures/wolfenstein/east.xpm

F 78,95,120
C 020,30,0

11111
1E011
11111