111111111111111111111
100000000000000000001
100000000000000000001
100000000000000000001
110000000000000000001
100000000000000000001
100000000000000000001
100000000000000000001  
100000000001000000011
100000000000000000001
100000000000000000001
100000000000000000001
100000000000000000001
110000000000000000001
100000000000000000001
111111111111111111111