NO textures/wolfenstein/grey_stone.xpm
SO textures/wolfenstein/purple_stone.xpm
WE textures/wolfenstein/red_brick.xpm
EA textures/wolfenstein/wood.xpm

F 220,100,0
C 225,30,0

111111111111111111111
100000101000000000001
100S00000001110000001
100000000000000001111
110000011110000000001
10001101   1000000001
100000001110000000011
1000000000001100001  
100011100000000000011
1101   11000011111111
11111    101111111111
1001     100000000001
111011111001001110001
11000000111 100000011
111001000001000000111
111111111111111111111